##########
#...#....#
#.#.#.##.#
#.#....#.#
#.###.@..#
#.#...##.#
#.#.#.##.#
#.#......#
###.######
#........#
##########