##########
#........#
#.#.#####.#
#.#.@.#...#
#.#####.#.#
#.......#.#
######.#.##
#........#.
#.#######.##
###########