####################
#.......@#........M#
#.######.#.#####.#.#
#......#.#.......#.#
#####.##.######.##.#
#.....#.......#M...#
#.###.###.###.###..#
#.#.......#........#
#.###.#####.###.##.#
#M..#.......#...##.#
###.#.#######.####.#
#...#.........#M...#
#.###.###.#####.####
#.....###.........##
#.###########.######
#.#...#E##........##
#...#...##........M#
####################