##########
#........#
#.####.###
#.#.@#...#
#.#.####.#
#.#...#...#
#.#.#.#.#.#
#.#.#.#.#.#
#...#.#...#
###########