########################################
#...................#.#................#
#.#.###########.#####.#.###########.###№
#.#...........#.....#.#.......#.....#..#
###.###########.#####.#######.###.###.##
#........................#............##
#####.###############.#####.###.########
#E..#......#.............#.............#
#.###############.###.#####.#.##########
#.#...#...#.....#...#.......#.........##
#.#.###.#####.#.###.#####.###.###.######
#.....#...#...#...#...........#.....#..#
###.###.###.#####.###.#.###.#######.####
#...............#.#.....#.......#.....##
###.###.#####.###.###.###.###########.##
#.#.....#.....#.........#....#.........#
#.###########.#.###.#.######.##..###.###
#...#...#...#...#...#.........#.#.....##
#.###.###.#.#####.###.###.#####.#.######
#.....#...#.........#.....#.....#.....##
#.###.##.###.###########.#####.###.###.#
#...#.....#.........#...........#.....##
#.#####.###.#.#####.###########.########
#...#.....#.#.........#..............###
###.###.#.#.#######.###.#.########.#####
#.....#.#.#...#...#..........#..#..#...#
#.###.###.###.#.###.#####.#######..#.###
#.#.....#.#.......#...........#........#
###.#####.#############.##.######.####.#
#...................#....#.######.#....#
#.###############.###.####.######.######
#....................................@##
########################################