####################
#.......@#.........#
#.######.#.#####.#.#
#......#.#.......#.#
#####.##.######.##.#
#.....#.......#....#
#.###.###.###.###..#
#.#.......#........#
#.###.#####.###.##.#
#...#.......#...##.#
###.#.#######.####.#
#...#.........#....#
#.###.###.#####.####
#.....###.........##
#.###########.######
#.#...#E##........##
#...#...##.........#
####################