###########################################################
#.........................................................#
#.#.#####################.#######.#######################.#
#.#.....................#.....#.#...#.....................#
###.###################.#.###.#.#.#.#.###################.#
#...#....................#...#...#.#.#......#.........#...#
#.###.###.#####.#####.#####.###########.###.###.#####.###.#
#...#...#.......#...#...#........#....#...#....#...#...#.##
#.#####.###.#####.#.#.###.###.#######.#####.#.###.###.###.#
#.#...#.#...#...#...#...#...#....#.......#.......#......###
#.###.#.###.#.###############.#########.###########.#####.#
#...#.#.....#..........#...#.#...#...#.......#.....#.....###
###.#####.#######.###.###.###.###.###.#.###########.###.###
#.#.#...#.#.........#...#.#...#.....#...#.....#.....#...###
#.#.###.#.#####.#.#####.#.#.#.#########.#.#.#######.#.#####
#........#........#.#......@#.#....................#......#
#.#########.#################.###.#########.###.#####.###.#
#........#...............#.....#...#............#...#.....#
#####.###.#.######.#####.###.###.#.#.###.###.###.#.###.##.#
#.#.....#.#.........#...#.#....................#......#...#
#.#####.###.###.#######.#######.##.###.###########.#####..#
#.#...#...#...........#...#...........#....#.#.......#....#
###.###.#####.#########.###.#######.###.######.###.######.#
#.#.........#.........#..#....#...#.....#.#...#.#...#.....#
#.###.#####.###.###.##.###.###.#.#########.#.###.###.###..#
#...#.....#...........#...#.#..#.#.......#.#.......#......#
#.###.#####.###############.#.###########.###.###.#####.###
#....#..#.#.#...#.................#.....#....#.#....#.....#
###########.###.#########.###.###.###.######.###.#######..#
#.............#...#...#.#...#...#.....#...#.......#......##
#.###.###.#####.###.###.#.###.#####.###.###.#.#.#.#.###.###
#.#.#...#.........#...#...#..#...#....#...#..#.#.#......###
#.#.#####.#####.###.######.#####.###.###.###.#####.###.####
#...................#.#...#.....#.........#...#.#.#...#####
#####.###.#.######.#####.###.###.#.#.###.###.###.#.##...###
#.#.....#.#.........#...#.#...#...#.....#......#......#.###
#.#####.###.###.#######.#######.##.###.###########.####..##
#.#...#...............#...#........#..#....#.#.......#....#
###.###.#######.#######.###.#####.#.###.######.###.######.#
###########.###.#########.#.#.###.###.######.###.#######..#
#.............#.........#...#...#.....#...#.......#.......#
#####.###.#####.###.###.#.###.#####.###.###.#.#.#.#.###.###
#.#.#...#.........#...#...#..#...#....#...#..#.#.#......###
###.#####.#####.###.######.#####.###E###.###.#####.###.####
###########################################################