##########
#........#
#.######.#
#.#.@..#.#
#.#.##.#.#
#.#..#...#
###.######
#...#....#
#.........
#########.