##################################################
#................................................#
#.#.###########.#####.#######.######.###.#########
#.#...........#...#.....#...#...#.#...#..........#
###.#####.###.###.###.###.###.###.###.########.###
#...#...#.#...#...#...#...#...#.......#..........#
###.###.#.#.#.#####.###.#####.###########.########
#.....#...#........#...#.....#.#.........#.......#
#####.###.#####.###.###.#######.########.###.###.#
#@..#.......#...#...........#...#.#.#.#######.#..#
###.#####.#####.#.#####.###.#.#.#.#...#....#.#...#
#.......#.....#...#...#...#.#.#####.#####.#.#.####
#.#.#####.#############.#.###.#.#.###...#.......##
#...#..............#...#.....#.....#...###########
###.###.###.#####.#####.#########.#.###....#....E#
#.......#.......#.......................#######.##
#######.###.#####.#######.###.###.#####...#.....##
#...#........#.......#...............#..###.###.##
#.#.###.#####..####.##########.#######.####..#...#
#.#.......#...##..#...#.#...#...#...#...###.#..###
#.#####.###.#####.###.#.#.###.###.###.#####.#.####
#.....#...#.......#......#...#...#.....#.......###
###.###.#####.###.#.###.#####.#.#####.###.###.#.##
#...#..........#.#...#.....#....##.##.###.....####
#.#.#####.#####.#.###.#.###.#.#.......###.#......#
#...#.....#...#........#......##########.#..##..##
#.#######.###.#####.#######.###########.#...##.###
#...#........#....#....#......####...#........####
#####.###########.#####.#####.#####.#.#####.###.##
#......###.......#..............#.#...#.....#..###
#......###......#.......................#.#####.##
######.####.#####.#######.###.###.#####...#.....##
#...#........#...#...#...............#..###.######
#.#.###.#####.#####.##########.#######.#.....#.###
#.#.......#...#...#...#.#...#...#...#.#.###.#..###
#.#####.###.#########.#.#.###.###.###.#.#.###.####
#.....#...#.......#......#...#...#...#.,...#.....#
###.###.#####.###.#.###.#####.#.#####.###.###.#.##
#...#..........#.#...#.....#.#.###.##.#.#........#
##################################################