##########
#........#
#.######.#
#.#..@.#.#
#.#.##.#.#
#.#..#.#.#
#.#.##.#.#
#.#......#
###.######
#........#
##########