###############################
#..........@.......##.........#
#.#.#####.#.#####.#.#.###.###.#
#.#.....#.#.....#.#.#.....###.#
###.###.#.###.###.#.#.#.#.###.#
#...#...#...#.....#.#.#.#.....#
#.###.#######.#####.#.#.#.###.#
#...#...#.......#.......#...#.#
#.#####.#######.#########.###.#
#...#.........#.......#.#.#...#
###.#####.###.###.#######.###.#
#.......#.#...................#
#.###.#.#.###.###.###########.#
#.....#.#...#.#.....#......#.##
###.#.###.###.#.#####.#.###.###
#...#...#.#........#.#.#...#.##
#.#####.#.#.#######.#.#.###.###
#.......#.#.........#.....#...#
#.#.###.####.#####.#####.###.##
#.#...#.........#.#.......#...#
#.###.###.###.###.#.###.###.###
#.......#.........#.........###
###.#####.#.#########.#####.###
#...#...........#......##.....#
#.###############.###.###.#####
#............................E#
###############################